MMMMMMMMMM
MMLLLLLLMM
LLLPPPPLLL
SPPPLLPPPE
LLLLMMLLLL
MMMMMMMMMM
MMMMMMMMMM