SPPPPPPPPP
LLLLLLLLLP
PPPPPPPPPP
PLLLLLLLLL
PPPPPPPPPP
LLLLLLLLLP
EPPPPPPPPP
