SPPPPPPPPL
LLLLLLLLPP
LPPPPPPLLP
PPLLLLPELP
PLLMMMLLLP
PPLLLLLLPP
LPPPPPPPPL